You wake up in a Janitor's closet after what you assume was a really long night. Not that you can remember it at all. You can barely remember anything, actually. All you know is that you work in a steelmill and that you want to quit your job in style.

metalworks
An Interactive Fiction by Ty Suthard
Release 1 / Serial number 140310 / Inform 7 build 6G60 (I6/v6.32 lib 6/12N) SD

Janitor's Closet
A Janitor's closet, just roomy enough for a body to pass out comfortably in. In the corner is the usual mop, there are some crumpled papers scattered around, and there's a large shelf with what looks like lots of cleaning supplies. To your south you can see a door.

>

I beg your pardon?

I beg your pardon?

* * *

I beg your pardon?

* * *

>take supplies
You stick one bottle of the stuff into one of the bigger pockets in your cargo shorts. The back of it has a label listing the chemicals it contains.

>break door
Maybe you should try kicking down the door instead?

>kick down door
You give a mighty kick towards the Door and it swings open wide for you, sending a few splinters your way. You can see a hallway to your south now.

>s
Hallway
A pretty boring hallway. You can see a window peering into an office to the west and a sign on the right.

>

>x window
Through the window you can see into what looks like your boss" office. You can't see much in there except for a desk and a trash bin.

>x sign
This sign labels the metalworking gear room to your East. It is orange.

* * *

>replay
That's not a verb I recognise.

* * *

>take cleaning supplies
You stick one bottle of the stuff into one of the bigger pockets in your cargo shorts. The back of it has a label listing the chemicals it contains.

>break door
Violence isn't the answer to this one.

>kick down door
You give a mighty kick towards the Door and it swings open wide for you, sending a few splinters your way. You can see a hallway to your south now.

>s
You should take that metalworking gear before you leave here first.

* * *

>take cleaning supplies
You stick one bottle of the stuff into one of the bigger pockets in your cargo shorts. The back of it has a label listing the chemicals it contains.

>break down door
You give a mighty kick towards the Door and it swings open wide for you, sending a few splinters your way. You can see a hallway to your south now.

>s
Hallway
A pretty boring hallway. You can see a window peering into an office to the west and a sign on the right.

>

* * *

>turn
What do you want to turn?

>turn on
What do you want to turn on?

>switch on
What do you want to switch on?

>switch on
What do you want to switch on?

>switch on blowtorch
You can't see any such thing.

* * *

>s
Uh, the door's locked. Darn. Looks like you'll have to come up with more creative ways to get out of here.

>break down door
You give a mighty kick towards the Door and it swings open wide for you, sending a few splinters your way. You can see a hallway to your south now.

>s
Hallway
A pretty boring hallway. You can see a window peering into an office to the west and a sign on the right.

...

>x sign
This sign labels the metalworking gear room to your East. It is orange.

>e
Gear Room
This gear room would be a lot like a locker room if there were any lockers. You can see a red button in the corner of the room next to a large steel door, and some metalworking clothes in another corner. There's a sign to the south next to the steel door.

…

You can also see a button and some metalworking gear here.

>take gear
Taken.

>x gear
Some heavy duty metalworking clothes, capable of keeping you cool in temperatures up to 500 degress celsius.

>x button
A big shiny red button next to the big steel door. I wonder what it does?

>press button
With a mighty tap, you depress the red button, such that it activates a mechanism, triggering a response in an electrical system, which in return activates the motors connected to the steel door, raising said door, revealing a passage to a catwalk to your south.

>n
You can't go that way.

>e
You can't go that way.

>w
Hallway
A pretty boring hallway. You can see a window peering into an office to the west and a sign on the right.

...

>n
Janitor's Closet
A Janitor's closet, just roomy enough for a body to pass out comfortably in. In the corner is the usual mop, there are some crumpled papers scattered around, and there's a large shelf with what looks like lots of cleaning supplies. To your south you can see a door.

...

...

>take supplies
You stick one bottle of the stuff into one of the bigger pockets in your cargo shorts. The back of it has a label listing the chemicals it contains.

>take mop
You try to be cool and use your shoelace to tie the mop around your back, like it was a battleaxe or something.

>s
Hallway
A pretty boring hallway. You can see a window peering into an office to the west and a sign on the right.

...

>e
Gear Room
This gear room would be a lot like a locker room if there were any lockers. You can see a red button in the corner of the room next to a large steel door, and some metalworking clothes in another corner. There's a sign to the south next to the steel door.

…

You can also see a button here.

>s
Catwalk
A large catwalk outside of the gear room. Unfortunately you can see your boss here, but you can also see an escape route to your west in the form of a stairwell.

…

…

Oh crap, it's your boss. The last thing you want to do is get talked to by him. You'd better get out of here.

>w
main floor
The main metalworking floor. In here you can see a few things lying on the floor, in the form of a pack of cigarettes and a blowtorch. To your west is another part of the floor.

…

…

…

>x pack
You can't see any such thing.

>x pack of cigarettes
You can't see any such thing.

>x cigarettes
A pack of "Marble" cigarettes. Ever since they found the loophole in placing warning labels, they're now covered with the label of "WARNING: Smoking is AWESOME."

>take cigarettes
.
You pick up the cigarettes and stick one in your mouth, not that you'd ever smoke it, you just figured you looked cooler that way.

>x cigs
A pack of "Marble" cigarettes. Ever since they found the loophole in placing warning labels, they're now covered with the label of "WARNING: Smoking is AWESOME."

>x torch
You can't see any such thing.

>x blowtorch
A blowtorch. It can be switched on and off by a valve near the nozzle.

The blowtorch is currently switched off.

>eat blowtorch
(first taking the blowtorch)
 Slow boss catch up go fast.
You come up with some creative ideas for a way to hold the tool, when you just decide to hold it in your hands
That's plainly inedible.

>w
You can't head west yet, not while in plain sight. You need to create a distraction somehow to get away from your boss.
 Those cigarettes you picked up look like that could be useful… d
west floor
You are now located in the room adjacent to the main floor to the west. You have dubbed this room the West Floor. IN here you can see some propane tanks and a cinderblock wall.

>x tanks
Some propane tanks. It's actually a bit odd that we left them on the main working floor. Who knows what sort of explosive capability they have?

>take tanks
They're hardly portable.

>x wall
 A cinderblock wall. Chances are it's not the strongest, it IS only made out cement or something anyways.

>i
You are carrying:
  a blowtorch
  some cigarettes
  a Mop
  a Label
  a Cleaning Supplies
  some metalworking gear

>x mop
A mop, complete with the weird fuzzy end. You muse that "it's like a water broom."

>x label
According to this white rectangle, this bottle of cleaning fluid contains a fair amount of ethanol. Your instincts from 8th Grade chemistry tell you that this is flammable.

>wear gear
You can't wear those!

>x gear
Some heavy duty metalworking clothes, capable of keeping you cool in temperatures up to 500 degress celsius.

>wear gear
You can't wear those!

>equip gear
That's not a verb I recognise.

>equip metalworking gear
That's not a verb I recognise.

>e
main floor
The main metalworking floor. In here you can see a few things lying on the floor, in the form of a pack of cigarettes and a blowtorch. To your west is another part of the floor.

…

>e
Dude, your boss is literally climbing down the stairs to talk to you, do you actually want to talk to him?

>talk to boss
You can't see any such thing.

>throw mop at boss
You can't see any such thing.

>throw mop
Dropped.

>take mop
You try to be cool and use your shoelace to tie the mop around your back, like it was a battleaxe or something.

>hit boss with mop
You can't see any such thing.

>w
You can't head west yet, not while in plain sight. You need to create a distraction somehow to get away from your boss.
 Those cigarettes you picked up look like that could be useful… d
west floor
You are now located in the room adjacent to the main floor to the west. You have dubbed this room the West Floor. IN here you can see some propane tanks and a cinderblock wall.

>w
Seriously, what is up with you and walking into walls

* * *

>turn blowtorch on
You switch the blowtorch on.

* * *

>throw mop at boss
You can't see any such thing.

>e
main floor
The main metalworking floor. In here you can see a few things lying on the floor, in the form of a pack of cigarettes and a blowtorch. To your west is another part of the floor.

…

* * *

>e
Dude, your boss is literally climbing down the stairs to talk to you, do you actually want to talk to him?

>throw mop at boss
You can't see any such thing.

>switch on blowtorch
That's already on.

>w
You can't head west yet, not while in plain sight. You need to create a distraction somehow to get away from your boss.
 Those cigarettes you picked up look like that could be useful… d
west floor
You are now located in the room adjacent to the main floor to the west. You have dubbed this room the West Floor. IN here you can see some propane tanks and a cinderblock wall.

>throw blowtorch at propane tanks
Futile.

* * *

>s
Uh, the door's locked. Darn. Looks like you'll have to come up with more creative ways to get out of here.

>take supplies
You stick one bottle of the stuff into one of the bigger pockets in your cargo shorts. The back of it has a label listing the chemicals it contains.

>break down door
You give a mighty kick towards the Door and it swings open wide for you, sending a few splinters your way. You can see a hallway to your south now.

>s
Hallway
A pretty boring hallway. You can see a window peering into an office to the west and a sign on your left.

>

>w
Office
You'd be hard pressed to find an office room more standard than this. You can see a trash bin and a plain wooden desk. You never really expected your boss to be very interesting anyways. To your East is the Hallway.

>take money
You stick this sweet cash in your pocket for later.

>e
Hallway
A pretty boring hallway. You can see a window peering into an office to the west and a sign on your left.

>

>e
Gear Room
This gear room would be a lot like a locker room if there were any lockers. You can see a red button in the corner of the room next to a large steel door, and some metalworking clothes in another corner. The steel door is to the south.

>

You can also see a button and some metalworking gear here.

>s
The, uh, steel door is closed, bud. There's probably an obvious way of opening it that you somehow missed.

>x button
A big shiny red button next to the big steel door. I wonder what it does?

>push button
With a mighty tap, you depress the red button, such that it activates a mechanism, triggering a response in an electrical system, which in return activates the motors connected to the steel door, raising said door, revealing a passage to a catwalk to your south. TL;DR, you opened the big steel door.

>x clothes
Some heavy duty metalworking clothes, capable of keeping you cool in temperatures up to 500 degress celsius.

>take clothes
Since you don't exactly have any means of carrying these bulky clothes, you decide to put them on instead.

>s
Catwalk
You find yourself on a large catwalk outside of the gear room. Unfortunately you can see your boss here, but you can also see an escape route to your west in the form of a stairwell.

>

>

>

I beg your pardon?

>talk to boss
No! You're literally asking for a conversation this way (You DON'T want that to happen, fyi).

>x stairwell
Some plain old metal stairs to your west. They lead down to the main floor of the steel mill.

>w
main floor
The main metalworking floor. Things are starting to look very industrial what with the grey interior and everything. And the grey walls. And the grey everything, really. To your west is another part of the floor.

>

In here you can see an blowtorch. Someone must've left it here.

You can alsosee a pack of cigarettes on the ground.

>x cigs
A pack of "Marble" cigarettes. Ever since they found the loophole in placing warning labels, they're now covered with the label of "WARNING: Smoking is AWESOME."

>take cigs
You pick up the cigarettes and attempt to stick one in your mouth, when you realize that you're wearing a helmet. You put the rest in your back pocket.

>x torch
A blowtorch. It can be switched on and off by a valve near the nozzle.

The blowtorch is currently switched off.

>switch on blowtorch
You switch the blowtorch on.

>turn on blowtorch
That's already on.

>x pack
You can't see any such thing.

>x pack of cigarettes
A pack of "Marble" cigarettes. Ever since they found the loophole in placing warning labels, they're now covered with the label of "WARNING: Smoking is AWESOME."

>w
You can't head west yet, not while in plain sight. You need to create a distraction somehow to get away from your boss.
Those cigarettes you picked up look like they could be useful… You should probably take that blowtorch as well.

>light cigs with blowtorch
You create a large plume of smoke, distracting your boss and masking your location temporarily. You can use this newfound time to escape to your west.
You switch off the blowtorch.

>actions
Actions listing on.

>light cigs with blowtorch
[firing the cigarettes]
You create a large plume of smoke, distracting your boss and masking your location temporarily. You can use this newfound time to escape to your west.
You switch off the blowtorch.

[firing the cigarettes - succeeded]

>light cigs with blowtorch
[firing the cigarettes]
You create a large plume of smoke, distracting your boss and masking your location temporarily. You can use this newfound time to escape to your west.
You switch off the blowtorch.

[firing the cigarettes - succeeded]

>w
[going west]
You manage to get out of the Main floor before the boss catches up to you, thanks to the cloud of smoke you just created.

west floor
You relocate yourself the other half of the Main Floor, handsomely titled, the West Floor. Of course, you have the equally drab furnishing of grey, absolutely everywhere here as well. There is not a lot going on here, save for some propane tanks stacked up against a cinderblock wall.

[going west - succeeded]

>s
[going south]
The cinderblock wall is nice and everything, but why are you trying to walk into it?
[going south - failed the Check going south]

>thin
That's not a verb I recognise.

>think
[thinking]
What a good idea.
[thinking - failed the block thinking rule]

>think about
What do you want to think about?

>think about propane tanks
[thinking about the Propane tanks]
Alright, propane is flammable. You need to ignite it somehow, but you can't stand next to it while you do so, that will surely blow your arm off… Maybe you have something on you that you can use to ignite it from a distance?

[thinking about the Propane tanks - succeeded]

>switch blowtorch on
You can't see any such thing.

>switch on blowtorch
You can't see any such thing.

>i
[taking inventory]
You are carrying:
  an ashpile
  some cigarettes
  some metalworking gear
  a Label
  a Cleaning Supplies

[taking inventory - succeeded]

>e
[going east]
Your boss is still close behind you, you don't want to talk to him.

main floor
The main metalworking floor. Things are starting to look very industrial what with the grey interior and everything. And the grey walls. And the grey everything, really. To your west is another part of the floor.

>

>

In here you can see an blowtorch. Someone must've left it here.

[going east - succeeded]

>x blowtorch
[examining the blowtorch]
A blowtorch. It can be switched on and off by a valve near the nozzle.

The blowtorch is currently switched on.

[examining the blowtorch - succeeded]

>take blowtorch
[taking the blowtorch]
You come up with some creative ideas for a way to hold the tool, when you just decide to hold it in your hands.
 Your boss is catching up. You'd better come up with some creative way to get out of his sight. Try thinking about some of the things you just picked up.
[taking the blowtorch - succeeded]

>switch off blowtorch
[switching off the blowtorch]
You switch the blowtorch off.
[switching off the blowtorch - succeeded]

>w
[going west]
You manage to get out of the Main floor before the boss catches up to you, thanks to the cloud of smoke you just created.

west floor
You relocate yourself the other half of the Main Floor, handsomely titled, the West Floor. Of course, you have the equally drab furnishing of grey, absolutely everywhere here as well. There is not a lot going on here, save for some propane tanks stacked up against a cinderblock wall.

[going west - succeeded]

>throw blowtorch
[dropping the blowtorch]
Did you mean to throw this at something?
[dropping the blowtorch - failed the Check dropping]

>take blowtorch
[taking the blowtorch]
You already have that.
[taking the blowtorch - failed the can't take what's already taken rule]

>i
[taking inventory]
You are carrying:
  a blowtorch
  an ashpile
  some cigarettes
  some metalworking gear
  a Label
  a Cleaning Supplies

[taking inventory - succeeded]

>think about blowtorch
[thinking about the blowtorch]
This blowtorch can make things really, really, hot. Enough to ignite anything that you can see, really. If you threw it next to a propane tank while it was turned on, you could probably set them off. Or you could do the sensible thing, and ignite them using some other method.

[thinking about the blowtorch - succeeded]

>think about propane tanks
[thinking about the Propane tanks]
Alright, propane is flammable. You need to ignite it somehow, but you can't stand next to it while you do so, that will surely blow your arm off… Maybe you have something on you that you can use to ignite it from a distance?

[thinking about the Propane tanks - succeeded]

>think about cleaning supplies
[thinking about the Cleaning Supplies]
Hmm… these cleaning supplies contain a lot of ethanol. Perhaps if you poured a trail, you could ignite the propane tanks from a safe distance.

[thinking about the Cleaning Supplies - succeeded]

>think about cigarettes
[thinking about the cigarettes]
You always knew that cigarettes were bad for you health, but have always simultaneously thought that people looked approximately 30% cooler when they had one sticking out of their mouth.

[thinking about the cigarettes - succeeded]

>pour cleaning supplies
What do you want to pour the Cleaning Supplies on?

>pour cleaning supplies on propane tanks
[pouring the Cleaning Supplies]
Your pour a trail of cleaning fluid from the propane tanks along the floor, giving you some distance away from the propane tanks.

[pouring the Cleaning Supplies - succeeded]

>light trail of cleaning supplies
[burning the trail of cleaning supplies]
This dangerous act would achieve little.
[burning the trail of cleaning supplies - failed the block burning rule]

>light cleaning supplies with blowtorch
(the Cleaning Supplies with the blowtorch)
[firing the Cleaning Supplies]
This isn't going to accomplish much with the blowtorch switched off.

[firing the Cleaning Supplies - succeeded]

>i
[taking inventory]
You are carrying:
  a blowtorch
  an ashpile
  some cigarettes
  some metalworking gear
  a Label
  a Cleaning Supplies

[taking inventory - succeeded]

>switch on blowtorch
[switching on the blowtorch]
You switch the blowtorch on.
[switching on the blowtorch - succeeded]

>light cleaning supplies with blowtorch
(the Cleaning Supplies with the blowtorch)
[firing the Cleaning Supplies]
The trail of cleaning supplies burns and leads up to the propane tanks, like a fuse of sorts. They propane tanks eventually ignite, and blast a gaping hole in the cinderblock wall, leading to another room.

[firing the Cleaning Supplies - succeeded]

>pour
What do you want to pour?

>pour cleaning supplies
You can't see any such thing.

>i
[taking inventory]
You are carrying:
  a blowtorch
  an ashpile
  some cigarettes
  some metalworking gear
  a Label

[taking inventory - succeeded]

>think
[thinking]
What a good idea.
[thinking - failed the block thinking rule]

>x cinderblock wall
[examining the cinderblock wall]
 A gaping whole is all that remains of the wall that was once here.

[examining the cinderblock wall - succeeded]

>s
[going south]
You proceed to move into the rubble.
Your boss arrives in the West Floor to assess the havok you just caused. 
[(1) looking]
ruined room
This place is ruined. There's debris everywhere, but the stairwell to your north is still standing, so that's nice.

>

[(1) looking - succeeded]

[going south - succeeded]

>s
[going south]

Crane Catwalk
You climb up the stairs and find yourself on yet another catwalk. There are some crane controls that control the metal bucket to your east at one end and a crane operator at the other.

>

 The crane operator gives you a cold stare from across the catwalk.

[going south - succeeded]

>n
[going north]

ruined room
This place is ruined. There's debris everywhere, but the stairwell to your north is still standing, so that's nice.

>

[going north - succeeded]

>undo
Crane Catwalk
[Previous turn undone.]

>l
[looking]
Crane Catwalk
You climb up the stairs and find yourself on yet another catwalk. There are some crane controls that control the metal bucket to your east at one end and a crane operator at the other.

>

 The crane operator gives you a cold stare from across the catwalk.

[looking - succeeded]

>talk to crane controller
You can't see any such thing.

>east
[going east]
You can't exactly go that way, but you can look at the crane controls and the bucket here.
[going east - failed the Check going east]

>talk to crane operator
[talking to the Crane Operator]
He doesn't say much back to you other than some mumbling about expensive bills and that he wishes he had a smoke.
[talking to the Crane Operator - ended without result]

>give the crane operator $20
You can't see any such thing.

>give the crane operator money
You can't see any such thing.

>i
[taking inventory]
You are carrying:
  a blowtorch
  an ashpile
  some cigarettes
  some metalworking gear
  a Label

[taking inventory - succeeded]

>give the crane operator cigs
[giving the cigarettes to the Crane Operator]
The crane operator takes your cigs and looks pretty happy now. He's too busy smoking to prevent you messing with his stuff at this point.
[giving the cigarettes to the Crane Operator - failed]

>i
[taking inventory]
You are carrying:
  a blowtorch
  an ashpile
  some metalworking gear
  a Label

[taking inventory - succeeded]

>use crane controls
[using the Crane Controls]
The crane operator is too busy smoking to care about all the safety rules you're violating right now and you see the steel bucket start moving back and forth, first closer to you, then back over to the big window.

Now, there's only one logical course of action. You need to jump on the steel bucket to escape.
[using the Crane Controls - succeeded]

>x crane operator
[examining the Crane Operator]
It's the crane operator. He looks pretty chill now that you've given him those cigarettes you found on the floor.

[examining the Crane Operator - succeeded]

>x metal bucket
You can't see any such thing.

>jump on metal bucket
You can't see any such thing.

>jump on steel bucket
[diving the steel bucket]
You leap on to the lip of the bucket, the hot steel searing your metalworking clothes slightly.

[(1) looking]
metal bucket
You are literally standing on the rim of a huge flaming metal bucket. I hope you feel good about yourself, for this is the day that you show your boss that you can be whoever you want to be, albeit with your shoes melting and on fire. Seriously though, you probably shouldn't stand up here for too much longer if you don't want your metalworking gear to fail. Luckily, the crane seems to be moving your bucket nearer to the big window. Now, the rest of your escape goes according to simple physics.

[(1) looking - succeeded]

[diving the steel bucket - succeeded]

>dive through window
[diving the big window]
You use all of your strength to leap as far and fast as you can off of the metal bucket through the large window, shattering the glass and sending you from your 40 foot freefall into a dumpster.

[(1) looking]
dumpster
A wonderful dumpster. It looks like you successfully made it out of the steel mill without letting your boss talk to you.

Oh look, a rat.

[(1) looking - succeeded]

[diving the big window - succeeded]

>x rat
[examining the rat]
A rat. He seems pretty content with you sitting there. He probably wouldn't mind to much if you picked him up actually.

[examining the rat - succeeded]

>pick up rat
[taking the rat]
"Squeak"[taking the rat - ended without result]

    *** You have won ***

Would you like to RESTART, RESTORE a saved game, QUIT or UNDO the last command?

* * *

>take mop
You try to be cool and use your shoelace to tie the mop around your back, like it was a battleaxe or something.

>take supplies
You stick one bottle of the stuff into one of the bigger pockets in your cargo shorts. The back of it has a label listing the chemicals it contains.

>kick dor
You can't see any such thing.

>kick door
You give a mighty kick towards the Door and it swings open wide for you, sending a few splinters your way. You can see a hallway to your south now.

>open door
It seems to be locked.

>s
Hallway
A pretty boring hallway. You can see a window peering into an office to the west and a sign on the right.

...

>w
Office
You'd be hard pressed to find an office room more standard than this. You can see a wheely chair, a trash bin, and a small filing cabinet, right next to the plain wooden desk.

>e
Hallway
A pretty boring hallway. You can see a window peering into an office to the west and a sign on the right.

...

>e
Gear Room
This gear room would be a lot like a locker room if there were any lockers. You can see a red button in the corner of the room next to a large steel door, and some metalworking clothes in another corner. There's a sign to the south next to the steel door.

…

You can also see a button and some metalworking gear here.

* * *

>take gear
Taken.

>press button
With a mighty tap, you depress the red button, such that it activates a mechanism, triggering a response in an electrical system, which in return activates the motors connected to the steel door, raising said door, revealing a passage to a catwalk to your south.

>w
Hallway
A pretty boring hallway. You can see a window peering into an office to the west and a sign on the right.

...

>e
Gear Room
This gear room would be a lot like a locker room if there were any lockers. You can see a red button in the corner of the room next to a large steel door, and some metalworking clothes in another corner. There's a sign to the south next to the steel door.

…

You can also see a button here.

* * *

>s
Catwalk
A large catwalk outside of the gear room. Unfortunately you can see your boss here, but you can also see an escape route to your west in the form of a stairwell.

…

…

Oh crap, it's your boss. The last thing you want to do is get talked to by him. You'd better get out of here.

>throw mop at boss
You lack the nerve when it comes to the crucial moment.

>e
You can't go that way.

>w
main floor
The main metalworking floor. In here you can see a few things lying on the floor, in the form of a pack of cigarettes and a blowtorch. To your west is another part of the floor.

…

…

…

>take cigs
.
You pick up the cigarettes and stick one in your mouth, not that you'd ever smoke it, you just figured you looked cooler that way.

>take blowtorch
 Slow boss catch up go fast.
You come up with some creative ideas for a way to hold the tool, when you just decide to hold it in your hands

>throw mop at boss
You can't see any such thing.

>w
You can't head west yet, not while in plain sight. You need to create a distraction somehow to get away from your boss.
 Those cigarettes you picked up look like that could be useful… d

>turn on blowtorch
You switch the blowtorch on.

>light cigs
This dangerous act would achieve little.

* * *

>x mop
A mop, complete with the weird fuzzy end. You muse that "it's like a water broom."

>x appers
You can't see any such thing.

>x paper
Some crumpled paper. There's actually not much to say about this. It's not really that interesting..

>x shelf
A large handy shelf full of things. There are plenty of cleaning supplies here. 

In the Shelf is a Cleaning Supplies.

>take cleaning supplies
You stick one bottle of the stuff into one of the bigger pockets in your cargo shorts. The back of it has a label listing the chemicals it contains.

>x cleaning supplies
 To any normal janitor this would be simple bottle of blue cleaning fluid, but in your eyes, you see lighter fluid! This ought to provide some pretty nice flames. The label on the back says the bottle contains lots of ethanol, a flammable molecule.

>x label
According to this white rectangle, this bottle of cleaning fluid contains a fair amount of ethanol. Your instincts from 8th Grade chemistry tell you that this is flammable.

>s
Uh, the door's locked. Darn. Looks like you'll have to come up with more creative ways to get out of here.

>x door
A pretty plain wooden door. It's locked, but it doesnt look that strong. Perhaps you could… break it down? I'm sure no one would mind.

>break down door
You give a mighty kick towards the Door and it swings open wide for you, sending a few splinters your way. You can see a hallway to your south now.

>x splinters
Tiny wooden fragments from after you kicked down that door to the janitor's closet. Tiny and insignificant. Like earth in comparison to the rest of the galaxy! How wonderful.

>s
Hallway
A pretty boring hallway. You can see a window peering into an office to the west and a sign on your left.

>

>x window
Through the window you can see into what looks like your boss's office. You can't see much in there except for a desk and a trash bin.

>x sign
This sign labels the metalworking gear room to your East. It is orange.

>w
Office
You'd be hard pressed to find an office room more standard than this. You can see a trash bin and a plain wooden desk. You never really expected your boss to be very interesting anyways. To your East is the Hallway.

>x trash
A standard metal trash can with some crumpled papers inside. Not a whole lot going on here.

>x papers
Some crumpled paper. There's actually not much to say about this. It's not really that interesting. De ja vu?.

>x desk
A boring, wooden desk. There's literally nothing special about it, but there is an open drawer.

>x drawer
An equally boring drawer for the boring desk.

In the drawer is a $20 bill.

>take money
You stick this sweet cash in your pocket for later.

* * *

>e
Hallway
A pretty boring hallway. You can see a window peering into an office to the west and a sign on your left.

>

>e
Gear Room
This gear room would be a lot like a locker room if there were any lockers. You can see a red button in the corner of the room next to a large steel door, and some metalworking clothes in another corner. The steel door is to the south.

>

>

>

>x clothes
Some heavy duty metalworking clothes, capable of keeping you cool in temperatures up to 500 degress celsius.

* * *

>take clothes
Since you don't exactly have any means of carrying these bulky clothes, you decide to put them on instead.

>x button
A big shiny red button next to the big steel door. I wonder what it does?

* * *

>push button
With a mighty tap, you depress the red button, such that it activates a mechanism, triggering a response in an electrical system, which in return activates the motors connected to the steel door, raising said door, revealing a passage to a catwalk to your south. TL;DR, you opened the big steel door.

>s
Catwalk
You find yourself on a large catwalk outside of the gear room. Unfortunately you can see your boss here, but you can also see an escape route to your west in the form of a stairwell.

>

>

>

>x boss
Your boss. The last thing you want to do is get talked to by him. You'd better get out of here.

>x stairwell
Some plain old metal stairs to your west. They lead down to the main floor of the steel mill.

>n
You'd rather get out of steel mill than retreat into the gear room.

>w
main floor
The main metalworking floor. Things are starting to look very industrial what with the grey interior and everything. And the grey walls. And the grey everything, really. To your west is another part of the floor.

>

In here you can see an blowtorch. Someone must've left it here.

You can also see a pack of cigarettes on the ground.

>w
You can't head west yet, not while in plain sight. You need to create a distraction somehow to get away from your boss.
 You should probably take that blowtorch as well.

>take blowtorch
You come up with some creative ideas for a way to hold the tool, when you just decide to hold it in your hands.

>take cigs
You pick up the cigarettes and attempt to stick one in your mouth, when you realize that you're wearing a helmet. You put the rest in your back pocket.
 Your boss is catching up. You'd better come up with some creative way to get out of his sight. Try thinking about some of the things you just picked up.

>think about blowtorch
This thing makes fire… Where there is fire, there is…

>think about cigs
Well you have in your hands what a lot of people call smokes. Smoke is generally good at hiding things. Where there is smoke there is fire. Hmmm…

>think about cigs
Well you have in your hands what a lot of people call smokes. Smoke is generally good at hiding things. Where there is smoke there is fire. Hmmm…

>x boss
You can't see any such thing.

>light cigs with blowtorch
You, uh, need to switch on the blowtorch to burn things.

>x blowtorch
A blowtorch. It can be switched on and off by a valve near the nozzle.

The blowtorch is currently switched off.

>switch on blow torch
You switch the blowtorch on.

>switch on blowtorch
That's already on.

>light cigs with blowtorch
You create a large plume of smoke, distracting your boss and masking your location temporarily. You can use this newfound time to escape to your west.

>west
You manage to get out of the Main floor before the boss catches up to you, thanks to the cloud of smoke you just created.

west floor
You relocate yourself the other half of the Main Floor, handsomely titled, the West Floor. Of course, you have the equally drab furnishing of grey, absolutely everywhere here as well. There is not a lot going on here, save for some propane tanks stacked up against a cinderblock wall.

>x cinderblock wall
 A cinderblock wall. Chances are it's not the strongest, it IS only made out cement or something anyways.

This is going to need some serious thinking to be able to get past here. Thinking. Maybe you need to THINK ABOUT some things. Things that are in this room in particular. Do you feel me?

>x propane tanks
Some propane tanks. It's actually a bit odd that we left them on the main working floor. Who knows what sort of explosive capability they have?

>think about propane tanks
Alright, propane is flammable. You need to ignite it somehow, but you can't stand next to it while you do so, that will surely blow your arm off… Maybe you have something on you that you can use to ignite it from a distance?

>think about cinderblock
Well, in order to not be cornered by your boss, you need to take down this wall. Those propane tanks definitely have the explosive capability to do such, it's just a matter of igniting them…

>think about cinderblock wall
Well, in order to not be cornered by your boss, you need to take down this wall. Those propane tanks definitely have the explosive capability to do such, it's just a matter of igniting them…

>x wall
 A cinderblock wall. Chances are it's not the strongest, it IS only made out cement or something anyways.

This is going to need some serious thinking to be able to get past here. Thinking. Maybe you need to THINK ABOUT some things. Things that are in this room in particular. Do you feel me?

>think about blowtorch
This blowtorch can make things really, really, hot. Enough to ignite anything that you can see, really. If you threw it next to a propane tank while it was turned on, you could probably set them off. Or you could do the sensible thing, and ignite them using some other method.

>think about cleaning supplies
Hmm… these cleaning supplies contain a lot of ethanol. Perhaps if you poured a trail, you could ignite the propane tanks from a safe distance.

>pour cleaning supplies
What do you want to pour the Cleaning Supplies on?

>pour cleaning supplies on propane tanks
Your pour a trail of cleaning fluid from the propane tanks along the floor, giving you some distance away from the propane tanks.

>switch on blowtorch
That's already on.

>light trail of cleaning supplies
This dangerous act would achieve little.

>switch off blowtorch
You switch the blowtorch off.

>light trail of cleaning supplies
This dangerous act would achieve little.

>light trail of cleaning supplies with blowtorch
This isn't going to accomplish much with the blowtorch switched off.

>switch on blowtorch
You switch the blowtorch on.

* * *

>x wall
 A gaping whole is all that remains of the wall that was once here.

* * *

>actions
Actions listing on.

>burn trail of cleaning supplies with blowtorch
[firing the trail of cleaning supplies]
[firing the trail of cleaning supplies - failed the Check firing]

>x blowtorch
[examining the blowtorch]
A blowtorch. It can be switched on and off by a valve near the nozzle.

The blowtorch is currently switched on.

[examining the blowtorch - succeeded]

>burn propane tanks with blowtorch
[firing the Propane tanks]
What propane tanks?

[firing the Propane tanks - succeeded]

>switch blowtorch on
[switching on the blowtorch]
That's already on.
[switching on the blowtorch - failed the can't switch on what's already on rule]

>x wall
[examining the cinderblock wall]
 A gaping whole is all that remains of the wall that was once here.

[examining the cinderblock wall - succeeded]

>undo
west floor
[Previous turn undone.]

>undo
west floor
[Previous turn undone.]

>undo
"Undo" failed.  [Not all interpreters provide it.]

>undo
"Undo" failed.  [Not all interpreters provide it.]

>l
[looking]
west floor
You relocate yourself the other half of the Main Floor, handsomely titled, the West Floor. Of course, you have the equally drab furnishing of grey, absolutely everywhere here as well.

[looking - succeeded]

>x wall
[examining the cinderblock wall]
 A gaping whole is all that remains of the wall that was once here.

[examining the cinderblock wall - succeeded]

>restart
[restarting the game]
Are you sure you want to restart?

* * *

>e
You take a few paces and trip over a mop in the corner.

>n
You casually walk into the wall.

>w
You take a few confident steps, right into the shelf.

You can't head west yet, not while in plain sight. You need to create a distraction somehow to get away from your boss.

You can't go that way.

>x mop
A mop, complete with the weird fuzzy end. You muse that "it's like a water broom."

>take mop
You try to be cool and use your shoelace to tie the mop around your back, like it was a battleaxe or something.

>x papers
You can't see any such thing.

>x paper
Some crumpled paper. There's actually not much to say about this. It's not really that interesting.

>take paper
That's hardly portable.

>x shelf
A large handy shelf full of things. There are plenty of cleaning supplies here. 

In the Shelf is a Cleaning Supplies.

>x cleaning supplies
 A plethora of cleaning supplies. You pick a few up to look at them and notice that many of them contain ethanol. Maybe this could come in handy if you want to "go out with a bang" like you said.

>take supplies
You stick one bottle of the stuff into one of the bigger pockets in your cargo shorts. The back of it has a label listing the chemicals it contains.

>x label
According to this white rectangle, this bottle of cleaning fluid contains a fair amount of ethanol. Your instincts from 8th Grade chemistry tell you that this is flammable.

* * *

>s
Uh, the door's locked. Darn. Looks like you'll have to come up with more creative ways to get out of here.

>x door
A pretty plain wooden door. It's locked, but it doesnt look that strong. That door was no match for you in the slightest.

>tackle door
That's not a verb I recognise.

>hit door
Violence isn't the answer to this one.

>punch door
Violence isn't the answer to this one.

>break door
Violence isn't the answer to this one.

>open door
It seems to be locked.

>kick door
You give a mighty kick towards the Door and it swings open wide for you, sending a few splinters your way. You can see a hallway to your south now.

>x splinters
You can't see any such thing.

>x hallway
You can't see any such thing.

>s
Hallway
A pretty boring hallway. You can see a window peering into an office to the west and a sign on the right.

...

* * *

>e
Gear Room
This gear room would be a lot like a locker room if there were any lockers. You can see a red button in the corner of the room next to a large steel door, and some metalworking clothes in another corner. There's a sign to the south next to the steel door.

…

You can also see a button and some metalworking gear here.

>w
You can't head west yet, not while in plain sight. You need to create a distraction somehow to get away from your boss.

Hallway
A pretty boring hallway. You can see a window peering into an office to the west and a sign on the right.

...

>x window
You can't see any such thing.

>x office
You can't see any such thing.

>take sign
That's hardly portable.

>x sign
This sign labels the metalworking gear room to your East. It is orange.

>x orange
You can't see any such thing.

>e
Gear Room
This gear room would be a lot like a locker room if there were any lockers. You can see a red button in the corner of the room next to a large steel door, and some metalworking clothes in another corner. There's a sign to the south next to the steel door.

…

You can also see a button and some metalworking gear here.

>x red button
You can't see any such thing.

>x sign
You can't see any such thing.

>x clothes
You can't see any such thing.

>push button
With a mighty tap, you depress the red button, such that it activates a mechanism, triggering a response in an electrical system, which in return activates the motors connected to the steel door, raising said door, revealing a passage to a catwalk to your south.

>s
Catwalk
A large catwalk outside of the gear room. Unfortunately you can see your boss here, but you can also see an escape route to your west in the form of a stairwell.

…

…

Oh crap, it's your boss. The last thing you want to do is get talked to by him. You'd better get out of here.

>n
You'd rather get out of here than retreat into the gear room.

>w
You can't head west yet, not while in plain sight. You need to create a distraction somehow to get away from your boss.

main floor
…

…

…

>x floor
You can't see any such thing.

>w
You can't head west yet, not while in plain sight. You need to create a distraction somehow to get away from your boss.

west floor
You are now located in the room adjacent to the main floor to the west. You have dubbed this room the West Floor. IN here you can see some propane tanks and a cinderblock wall.

* * *

>break down door
You give a mighty kick towards the Door and it swings open wide for you, sending a few splinters your way. You can see a hallway to your south now.

>s
Wait! Are you sure you have everything you might need from this room?

>take cleaning supplies
You stick one bottle of the stuff into one of the bigger pockets in your cargo shorts. The back of it has a label listing the chemicals it contains.

>s
Hallway
A pretty boring hallway. You can see a window peering into an office to the west and a sign on your left.

>

>west
Office
You'd be hard pressed to find an office room more standard than this. You can see a trash bin and a plain wooden desk. You never really expected your boss to be very interesting anyways. To your East is the Hallway.

>take money
You stick this sweet cash in your pocket for later.

* * *

>e
Gear Room
This gear room would be a lot like a locker room if there were any lockers. You can see a red button in the corner of the room next to a large steel door, and some metalworking clothes in another corner. The steel door is to the south.

>

>

>

>take clothes
Since you don't exactly have any means of carrying these bulky clothes, you decide to put them on instead.

>push button
With a mighty tap, you depress the red button, such that it activates a mechanism, triggering a response in an electrical system, which in return activates the motors connected to the steel door, raising said door, revealing a passage to a catwalk to your south.

>s
Catwalk
You find yourself on a large catwalk outside of the gear room. Unfortunately you can see your boss here, but you can also see an escape route to your west in the form of a stairwell.

>

>

>

* * *

>x boss
Your boss. The last thing you want to do is get talked to by him. You'd better get out of here.

>west
main floor
The main metalworking floor. Things are starting to look very industrial what with the grey interior and everything. And the grey walls. And the grey everything, really. To your west is another part of the floor.

>

In here you can see an blowtorch. Someone must've left it here.

You can also see a pack of cigarettes on the ground.

>take torc
You can't see any such thing.

>take torch
You come up with some creative ideas for a way to hold the tool, when you just decide to hold it in your hands.

>take cigs
You pick up the cigarettes and attempt to stick one in your mouth, when you realize that you're wearing a helmet. You put the rest in your back pocket.
 Your boss is catching up. You'd better come up with some creative way to get out of his sight. Try thinking about some of the things you just picked up.

>undo
main floor
[Previous turn undone.]

>undo
main floor
[Previous turn undone.]

>take cigs
You pick up the cigarettes and attempt to stick one in your mouth, when you realize that you're wearing a helmet. You put the rest in your back pocket.

>take torch
You come up with some creative ideas for a way to hold the tool, when you just decide to hold it in your hands.
 Your boss is catching up. You'd better come up with some creative way to get out of his sight. Try thinking about some of the things you just picked up.

>think about blowtorch
This thing makes fire… Where there is fire, there is…

* * *

>think about cigs
Well you have in your hands what a lot of people call smokes. Smoke is generally good at hiding things. Where there is smoke there is fire. Hmmm…

>light cigs with blowtorch
You, uh, need to switch on the blowtorch to burn things.

>switch on blowtorch
You switch the blowtorch on.

>light cigs with blowtorch
You create a large plume of smoke, distracting your boss and masking your location temporarily. You can use this newfound time to escape to your west.

* * *

>west
You manage to get out of the Main floor before the boss catches up to you, thanks to the cloud of smoke you just created.

west floor
You relocate yourself the other half of the Main Floor, handsomely titled, the West Floor. Of course, you have the equally drab furnishing of grey, absolutely everywhere here as well. There is not a lot going on here, save for some propane tanks stacked up against a cinderblock wall.

>x propane tanks
Some propane tanks. It's actually a bit odd that we left them on the main working floor. Who knows what sort of explosive capability they have?

>x cinderblock wall
 A cinderblock wall. Chances are it's not the strongest, it IS only made out cement or something anyways.

This is going to need some serious thinking to be able to get past here. Thinking. Maybe you need to THINK ABOUT some things. Things that are in this room in particular. Do you feel me?

>x wall
 A cinderblock wall. Chances are it's not the strongest, it IS only made out cement or something anyways.

This is going to need some serious thinking to be able to get past here. Thinking. Maybe you need to THINK ABOUT some things. Things that are in this room in particular. Do you feel me?

>think about cleaning supplies
Hmm… these cleaning supplies contain a lot of ethanol. Perhaps if you poured a trail, you could ignite the propane tanks from a safe distance.

>think about blowtorch
This blowtorch can make things really, really, hot. Enough to ignite anything that you can see, really. If you threw it next to a propane tank while it was turned on, you could probably set them off. Or you could do the sensible thing, and ignite them using some other method.

>think about wall
Well, in order to not be cornered by your boss, you need to take down this wall. Those propane tanks definitely have the explosive capability to do such, it's just a matter of igniting them…

>think about tanks
Alright, propane is flammable. You need to ignite it somehow, but you can't stand next to it while you do so, that will surely blow your arm off… Maybe you have something on you that you can use to ignite it from a distance?

>pour cleaning supplies
What do you want to pour the Cleaning Supplies on?

* * *

>pour cleaning supplies on propane tanks
Your pour a trail of cleaning fluid from the propane tanks along the floor, giving you some distance away from the propane tanks.

>light trail of cleaning supplies with blowtorch
The trail of cleaning supplies burns and leads up to the propane tanks, like a fuse of sorts. They propane tanks eventually ignite, and blast a gaping hole in the cinderblock wall, leading to another room.

>x wall
 A gaping whole is all that remains of the wall that was once here.

>undo
west floor
[Previous turn undone.]

>x wall
 A cinderblock wall. Chances are it's not the strongest, it IS only made out cement or something anyways.

This is going to need some serious thinking to be able to get past here. Thinking. Maybe you need to THINK ABOUT some things. Things that are in this room in particular. Do you feel me?

>actions
Actions listing on.

>x wall
[examining the cinderblock wall]
 A cinderblock wall. Chances are it's not the strongest, it IS only made out cement or something anyways.

This is going to need some serious thinking to be able to get past here. Thinking. Maybe you need to THINK ABOUT some things. Things that are in this room in particular. Do you feel me?
[examining the cinderblock wall - succeeded]

>light trail of cleaning supplies
[burning the trail of cleaning supplies]
Did you mean to light the trail of cleaning supplies with something?
[burning the trail of cleaning supplies - failed]

>light trail of cleaning supplies with blowtorch
[firing the trail of cleaning supplies]
The trail of cleaning supplies burns and leads up to the propane tanks, like a fuse of sorts. They propane tanks eventually ignite, and blast a gaping hole in the cinderblock wall, leading to another room.

[firing the trail of cleaning supplies - succeeded]

>undo
west floor
[Previous turn undone.]

>torch trail of cleaning supplies with blowtorch
[firing the trail of cleaning supplies]
The trail of cleaning supplies burns and leads up to the propane tanks, like a fuse of sorts. They propane tanks eventually ignite, and blast a gaping hole in the cinderblock wall, leading to another room.

[firing the trail of cleaning supplies - succeeded]

>undo
west floor
[Previous turn undone.]

>light cleaning supplies
[burning the trail of cleaning supplies]
Did you mean to light the trail of cleaning supplies with something?
[burning the trail of cleaning supplies - failed]

>light the cleaning supplies with blowtorch
[firing the trail of cleaning supplies]
The trail of cleaning supplies burns and leads up to the propane tanks, like a fuse of sorts. They propane tanks eventually ignite, and blast a gaping hole in the cinderblock wall, leading to another room.

[firing the trail of cleaning supplies - succeeded]

>x wall
[examining the cinderblock wall]
 A gaping whole is all that remains of the wall that was once here.

[examining the cinderblock wall - succeeded]

>s
[going south]
You proceed to move into the rubble.
Your boss arrives in the West Floor to assess the havok you just caused. 
[(1) looking]
ruined room
This place is ruined. There's debris everywhere, but the stairwell to your north is still standing, so that's nice.

>

[(1) looking - succeeded]

[going south - succeeded]

* * *

>s
[going south]

Crane Catwalk
You climb up the stairs and find yourself on yet another catwalk. There are some crane controls that control the metal bucket to your east at one end and a crane operator at the other.

>

 The crane operator gives you a cold stare from across the catwalk.

[going south - succeeded]

>x crane operator
[examining the Crane Operator]
The crane operator here looks like he operates the crane controls located on this catwalk. He looks like he's a pretty cool guy. No, wait, he actually looks pretty stingy about something.

[examining the Crane Operator - succeeded]

>talk to crane operator
[talking to the Crane Operator]
He doesn't say much back to you other than some mumbling about expensive bills and that he wishes he had a smoke.
[talking to the Crane Operator - ended without result]

>give cigs to crane operator
[giving the cigarettes to the Crane Operator]
The crane operator takes your cigs and looks pretty happy now. He's too busy smoking to prevent you messing with his stuff at this point.
[giving the cigarettes to the Crane Operator - failed]

>e
[going east]
You can't exactly go that way, but you can look at the crane controls and the bucket here.
[going east - failed the Check going east]

>x crane controls
[examining the Crane Controls]
It looks like these levers and buttons and whatnot control crane carrying the huge flaming metal bucket full of molten steel.

[examining the Crane Controls - succeeded]

>x bucket
[examining the steel bucket]
A flaming bucket full of molten steel. The rail that bucket is hanging from is part of the crane, and it looks like it can move back and forth near the big window you can see behind it.

[examining the steel bucket - succeeded]

>use crane controls
[using the Crane Controls]
The crane operator is too busy smoking to care about all the safety rules you're violating right now and you see the steel bucket start moving back and forth, first closer to you, then back over to the big window.

Now, there's only one logical course of action. You need to jump on the steel bucket to escape.
[using the Crane Controls - succeeded]

>jump on steel bucket
[diving the steel bucket]
You leap on to the lip of the bucket, the hot steel searing your metalworking clothes slightly.

[(1) looking]
metal bucket
You are literally standing on the rim of a huge flaming metal bucket. I hope you feel good about yourself, for this is the day that you show your boss that you can be whoever you want to be, albeit with your shoes melting and on fire. Seriously though, you probably shouldn't stand up here for too much longer if you don't want your metalworking gear to fail. Luckily, the crane seems to be moving your bucket nearer to the big window. Now, the rest of your escape goes according to simple physics.

[(1) looking - succeeded]

[diving the steel bucket - succeeded]

>x window
[examining the big window]
 You can see the big window peering into the outside world. Escape! You are so close now!

[examining the big window - succeeded]

>dive through window
[diving the big window]
You use all of your strength to leap as far and fast as you can off of the metal bucket through the large window, shattering the glass and sending you from your 40 foot freefall into a dumpster.

[(1) looking]
dumpster
A wonderful dumpster. It looks like you successfully made it out of the steel mill without letting your boss talk to you.

Oh look, a rat.

[(1) looking - succeeded]

[diving the big window - succeeded]

* * *

>break down door
You give a mighty kick towards the Door and it swings open wide for you, sending a few splinters your way. You can see a hallway to your south now.

>take supplies
You stick one bottle of the stuff into one of the bigger pockets in your cargo shorts. The back of it has a label listing the chemicals it contains.

>s
Uh, the door is closed. There's probably an obvious way of opening it that you missed.

>w
Office
You'd be hard pressed to find an office room more standard than this. You can see a trash bin and a plain wooden desk. You never really expected your boss to be very interesting anyways. To your East is the Hallway.

>open drawer
That's already open.

>x desk
A boring, wooden desk. There's literally nothing special about it, but there is an open drawer.

* * *

>x drawer
An equally boring drawer for the boring desk.

In the drawer is a $20 bill.

>take money
Taken.

>x trash bin
A standard metal trash can with some crumpled papers inside. Not a whole lot going on here.

>x paper
Some crumpled paper. There's actually not much to say about this. It's not really that interesting.

>e
Hallway
A pretty boring hallway. You can see a window peering into an office to the west and a sign on your left.

>

>x sign
This sign labels the metalworking gear room to your East. It is orange.

* * *

>e
Gear Room
This gear room would be a lot like a locker room if there were any lockers. You can see a red button in the corner of the room next to a large steel door, and some metalworking clothes in another corner. There's a sign to the south next to the steel door.

…

You can also see a button and some metalworking gear here.

>x clothes
Some heavy duty metalworking clothes, capable of keeping you cool in temperatures up to 500 degress celsius.

* * *

>s
Uh, the door is closed. There's probably an obvious way of opening it that you missed.

>x window
Through the window you can see into what looks like your boss's office. You can't see much in there except for a desk and a trash bin.

* * *

>s
Uh, the door is closed. There's probably an obvious way of opening it that you missed.

>x office
Through the window you can see into what looks like your boss's office. You can't see much in there except for a desk and a trash bin.

>w
Office
You'd be hard pressed to find an office room more standard than this. You can see a wheely chair, a trash bin, and a small filing cabinet, right next to the plain wooden desk. You never really expected your boss to be very interesting anyways. To your East is the Hallway.

* * *

>s
Uh, the door is closed. There's probably an obvious way of opening it that you missed.

>e
You take a few paces and trip over a mop in the corner.

>take money
You can't see any such thing.

>w
You take a few confident steps, right into the shelf.

>w
You take a few confident steps, right into the shelf.

>take money
You can't see any such thing.

I beg your pardon?

>e
You take a few paces and trip over a mop in the corner.

>e
You take a few paces and trip over a mop in the corner.

>w
You take a few confident steps, right into the shelf.

>n
You casually walk into the wall.

>s
Uh, the door is closed. There's probably an obvious way of opening it that you missed.

* * *

>e
You take a few paces and trip over a mop in the corner.

>x sign
You can't see any such thing.

>w
You take a few confident steps, right into the shelf.

>e
You take a few paces and trip over a mop in the corner.

* * *

>take supplies
You stick one bottle of the stuff into one of the bigger pockets in your cargo shorts. The back of it has a label listing the chemicals it contains.

>x splinters
Tiny wooden fragments from after you kicked down that door to the janitor's closet. Tiny and insignificant. Like earth in comparison to the rest of the galaxy! How wonderful.

>take splinters
You bend down to pick a few up when you realize that what you are doing makes absolutely no sense.

>s
Hallway
A pretty boring hallway. You can see a window peering into an office to the west and a sign on your left.

>

>x sign
This sign labels the metalworking gear room to your East. It is orange.

>west
Office
You'd be hard pressed to find an office room more standard than this. You can see a wheely chair, a trash bin, and a small filing cabinet, right next to the plain wooden desk. You never really expected your boss to be very interesting anyways.

>s
You can't go that way.

* * *

>take splinters
You bend down to pick a few up when you realize that what you are doing makes absolutely no sense.

>take cleaning supplies
You stick one bottle of the stuff into one of the bigger pockets in your cargo shorts. The back of it has a label listing the chemicals it contains.

* * *

>x label
You can't see any such thing.