metalworks
An Interactive Fiction by Ty Suthard Hopefully i can get a teleport command in here eventually so it's easier to test this darn thing
Release 1 / Serial number 140305 / Inform 7 build 6G60 (I6/v6.32 lib 6/12N) SD

Janitor's Closet
A Janitor's closet, just roomy enough for a body to pass out comfortably in. In the corner is the usual mop, there are some crumpled papers scattered around, and there's a large shelf with what looks like lots of cleaning supplies. To your south you can see a door.

...

...

I beg your pardon?

* * *

metalworks
An Interactive Fiction by Ty Suthard Hopefully i can get a teleport command in here eventually so it's easier to test this darn thing
Release 1 / Serial number 140305 / Inform 7 build 6G60 (I6/v6.32 lib 6/12N) SD

Janitor's Closet
A Janitor's closet, just roomy enough for a body to pass out comfortably in. In the corner is the usual mop, there are some crumpled papers scattered around, and there's a large shelf with what looks like lots of cleaning supplies. To your south you can see a door.

...

...

>x
What do you want to examine?

>x everything
(yourself)
As good-looking as ever.

* * *

>x
What do you want to examine?

>l
Janitor's Closet
A Janitor's closet, just roomy enough for a body to pass out comfortably in. In the corner is the usual mop, there are some crumpled papers scattered around, and there's a large shelf with what looks like lots of cleaning supplies. To your south you can see a door.

You can see a Door to the Janitor's Closet Door and a Mop here.

* * *

metalworks
An Interactive Fiction by Ty Suthard Hopefully i can get a teleport command in here eventually so it's easier to test this darn thing
Release 1 / Serial number 140305 / Inform 7 build 6G60 (I6/v6.32 lib 6/12N) SD

Janitor's Closet
A Janitor's closet, just roomy enough for a body to pass out comfortably in. In the corner is the usual mop, there are some crumpled papers scattered around, and there's a large shelf with what looks like lots of cleaning supplies. To your south you can see a door.

...

...

>kick door
That's not a verb I recognise.

* * *

metalworks
An Interactive Fiction by Ty Suthard Hopefully i can get a teleport command in here eventually so it's easier to test this darn thing
Release 1 / Serial number 140305 / Inform 7 build 6G60 (I6/v6.32 lib 6/12N) SD

Janitor's Closet
A Janitor's closet, just roomy enough for a body to pass out comfortably in. In the corner is the usual mop, there are some crumpled papers scattered around, and there's a large shelf with what looks like lots of cleaning supplies. To your south you can see a door.

...

...

>take cleaning supplies
You stick one bottle of the stuff into one of the bigger pockets in your cargo shorts. The back of it has a label listing the chemicals it contains.

>x label
According to this white rectangle, this bottle of cleaning fluid contains a fair amount of ethanol. Your instincts from 8th Grade chemistry tell you that this is flammable.

* * *

metalworks
An Interactive Fiction by Ty Suthard Hopefully i can get a teleport command in here eventually so it's easier to test this darn thing
Release 1 / Serial number 140305 / Inform 7 build 6G60 (I6/v6.32 lib 6/12N) SD

Janitor's Closet
A Janitor's closet, just roomy enough for a body to pass out comfortably in. In the corner is the usual mop, there are some crumpled papers scattered around, and there's a large shelf with what looks like lots of cleaning supplies. To your south you can see a door.

...

...

>x door
A pretty plain wooden door. It's locked, but it doesnt look that strong. That door was no match for you in the slightest.

>kick down door
You give a mighty kick towards the Door and it swings open wide for you, sending a few splinters your way. You can see a hallway to your south now.

>s
why are you trying to walk into a wall
Hallway
A pretty boring hallway. You can see a window peering into an office to the west and a sign on the right.

...

>s
why are you trying to walk into a wall
You can't go that way.

>s
why are you trying to walk into a wall
You can't go that way.

* * *

>x door
A pretty plain wooden door. It's locked, but it doesnt look that strong. That door was no match for you in the slightest.

>open door
It seems to be locked.

>s
Hallway
You can see a Door to the Janitor's Closet here.

>restart
Are you sure you want to restart?

* * *

metalworks
An Interactive Fiction by Ty Suthard Hopefully i can get a teleport command in here eventually so it's easier to test this darn thing
Release 1 / Serial number 140305 / Inform 7 build 6G60 (I6/v6.32 lib 6/12N) SD

Janitor's Closet
A Janitor's closet, just roomy enough for a body to pass out comfortably in. In the corner is the usual mop, there are some crumpled papers scattered around, and there's a large shelf with what looks like lots of cleaning supplies. To your south you can see a door.

...

...

>take key
It's actually a bit strange that it's in here, you figured sooner or later you would have to resort to kicking down the door, which you probably could have managed, you just chose to take the less aggressive course of action, which is fine, I suppose. I mean, it's certainly not as spectacular as kicking down a door, but it worked for you.

>unlock Janitor's Closet door with Key
(first taking the Janitor's Key)
It's actually a bit strange that it's in here, you figured sooner or later you would have to resort to kicking down the door, which you probably could have managed, you just chose to take the less aggressive course of action, which is fine, I suppose. I mean, it's certainly not as spectacular as kicking down a door, but it worked for you.

>x door
A pretty plain wooden door. It looks fairly sturdy, but nothing top notch, and it's locked anyways.

>x key
The key to the Janitor's closet. It's actually a bit strange that it's in here, you figured you would have had to bust down the door, which you probably could have, you just chose to take the less aggressive course of action.

* * *

>take key
It's actually a bit strange that it's in here, you figured sooner or later you would have to resort to kicking down the door, which you probably could have managed, you just chose to take the less aggressive course of action, which is fine, I suppose. I mean, it's certainly not as spectacular as kicking down a door, but it worked for you.

>unlock door with key
You unlock the Door to the Janitor's Closet.

>actions
Actions listing on.

>unlock door with key
[unlocking the Door to the Janitor's Closet with the Janitor's Key]
(first taking the Janitor's Key)
[(1) taking the Janitor's Key - silently]
It's actually a bit strange that it's in here, you figured sooner or later you would have to resort to kicking down the door, which you probably could have managed, you just chose to take the less aggressive course of action, which is fine, I suppose. I mean, it's certainly not as spectacular as kicking down a door, but it worked for you.
[(1) taking the Janitor's Key - silently - failed]
[unlocking the Door to the Janitor's Closet with the Janitor's Key - failed the carrying requirements rule]

* * *

>unlock door with key
You unlock the Door to the Janitor's Closet.

>open door
You open the Door to the Janitor's Closet.

>s
Hallway
You can see a Door to the Janitor's Closet here.

* * *

>open door
You open the Door to the Janitor's Closet.

>unlock janitor's closet door with key
(first taking the Janitor's Key)
It's actually a bit strange that it's in here, you figured sooner or later you would have to resort to kicking down the door, which you probably could have managed, you just chose to take the less aggressive course of action, which is fine, I suppose. I mean, it's certainly not as spectacular as kicking down a door, but it worked for you.

>actions
Actions listing on.

* * *

metalworks
An Interactive Fiction by Ty Suthard Hopefully i can get a teleport command in here eventually so it's easier to test this darn thing
Release 1 / Serial number 140305 / Inform 7 build 6G60 (I6/v6.32 lib 6/12N) SD

Janitor's Closet
A Janitor's closet, just roomy enough for a body to pass out comfortably in. In the corner is the usual mop, there are some crumpled papers scattered around, and there's a large shelf with what looks like lots of cleaning supplies. To your south you can see a door.

...

...

>turn
What do you want to turn?

* * *

metalworks
An Interactive Fiction by Ty Suthard Hopefully i can get a teleport command in here eventually so it's easier to test this darn thing
Release 1 / Serial number 140305 / Inform 7 build 6G60 (I6/v6.32 lib 6/12N) SD

Janitor's Closet
A Janitor's closet, just roomy enough for a body to pass out comfortably in. In the corner is the usual mop, there are some crumpled papers scattered around, and there's a large shelf with what looks like lots of cleaning supplies. To your south you can see a door.

...

...

>open door
It seems to be locked.

>s
(first opening the Door to the Janitor's Closet)
It seems to be locked.

* * *

metalworks
An Interactive Fiction by Ty Suthard Hopefully i can get a teleport command in here eventually so it's easier to test this darn thing
Release 1 / Serial number 140305 / Inform 7 build 6G60 (I6/v6.32 lib 6/12N) SD

Janitor's Closet
A Janitor's closet, just roomy enough for a body to pass out comfortably in. In the corner is the usual mop, there are some crumpled papers scattered around, and there's a large shelf with what looks like lots of cleaning supplies. To your south you can see a door.

...

...

>kick down door
You give a mighty kick towards the Door and it swings open wide for you, sending a few splinters your way. You can see a hallway to your south now.

>s
Hallway
You can see a Door to the Janitor's Closet here.

* * *

>kick down door
You give a mighty kick towards the Door and it swings open wide for you, sending a few splinters your way. You can see a hallway to your south now.

>x door
A pretty plain wooden door.  That door was no match for you in the slightest.

>restart
Are you sure you want to restart?

* * *

metalworks
An Interactive Fiction by Ty Suthard Hopefully i can get a teleport command in here eventually so it's easier to test this darn thing
Release 1 / Serial number 140305 / Inform 7 build 6G60 (I6/v6.32 lib 6/12N) SD

Janitor's Closet
A Janitor's closet, just roomy enough for a body to pass out comfortably in. In the corner is the usual mop, there are some crumpled papers scattered around, and there's a large shelf with what looks like lots of cleaning supplies. To your south you can see a door.

...

...

>s
(first opening the Door to the Janitor's Closet)
It seems to be locked.

* * *

metalworks
An Interactive Fiction by Ty Suthard Hopefully i can get a teleport command in here eventually so it's easier to test this darn thing
Release 1 / Serial number 140305 / Inform 7 build 6G60 (I6/v6.32 lib 6/12N) SD

Janitor's Closet
A Janitor's closet, just roomy enough for a body to pass out comfortably in. In the corner is the usual mop, there are some crumpled papers scattered around, and there's a large shelf with what looks like lots of cleaning supplies. To your south you can see a door.

...

...

>test
>--> No test scripts exist for this game.

>replay
That's not a verb I recognise.

>press bookshelf
You can't see any such thing.

>press
What do you want to press?

* * *

metalworks
An Interactive Fiction by Ty Suthard Hopefully i can get a teleport command in here eventually so it's easier to test this darn thing
Release 1 / Serial number 140305 / Inform 7 build 6G60 (I6/v6.32 lib 6/12N) SD

Janitor's Closet
A Janitor's closet, just roomy enough for a body to pass out comfortably in. In the corner is the usual mop, there are some crumpled papers scattered around, and there's a large shelf with what looks like lots of cleaning supplies. To your south you can see a door.

...

...

>x paper
Some crumpled paper. There's actually not much to say about this. It's not really that interesting.

* * *

metalworks
An Interactive Fiction by Ty Suthard Hopefully i can get a teleport command in here eventually so it's easier to test this darn thing
Release 1 / Serial number 140305 / Inform 7 build 6G60 (I6/v6.32 lib 6/12N) SD

Janitor's Closet
A Janitor's closet, just roomy enough for a body to pass out comfortably in. In the corner is the usual mop, there are some crumpled papers scattered around, and there's a large shelf with what looks like lots of cleaning supplies. To your south you can see a door.

...

...

>x shelf
A large handy shelf full of things. There are plenty of cleaning supplies here. 

In the Shelf is a Cleaning Supplies.

* * *

>x label
According to this white rectangle, this bottle of cleaning fluid contains a fair amount of ethanol. Your instincts from 8th Grade chemistry tell you that this is flammable.

>take mop
Taken.

>s
why are you trying to walk into a wall
(first opening the Door to the Janitor's Closet)
It seems to be locked.

>take key
You can't see any such thing.

>x door
A pretty plain wooden door. It's locked, but it doesnt look that strong.   That door was no match for you in the slightest.

>break down door
You give a mighty kick towards the Door and it swings open wide for you, sending a few splinters your way. You can see a hallway to your south now.

>x splinters
You can't see any such thing.

* * *

>take mop
Taken.

>open door
It seems to be locked.

>x dor
You can't see any such thing.

>x door
A pretty plain wooden door. It's locked, but it doesnt look that strong.

>kick down door
You give a mighty kick towards the Door and it swings open wide for you, sending a few splinters your way. You can see a hallway to your south now.

>s
Hallway
A pretty boring hallway. You can see a window peering into an office to the west and a sign on the right.

You can see a Door to the Janitor's Closet here.

>w
Office
You'd be hard pressed to find an office room more standard than this. You can see a wheely chair, a trash bin, and a small filing cabinet, right next to the plain wooden desk.

>x desk
A boring, wooden desk. There's literally nothing special about it, but there is a closed drawer.

>open drawer
That's already open.

>x drawer
An equally boring drawer for the boring desk.

In the drawer is a $20 bill.

>take bill
Taken.

>w
You can't go that way.

>e
Hallway
A pretty boring hallway. You can see a window peering into an office to the west and a sign on the right.

You can see a Door to the Janitor's Closet here.

>x sign
You can't see any such thing.

>e
Gear Room
This gear room would be a lot like a locker room if there were any lockers. You can see a red button in the corner of the room next to a large steel door, and some metalworking clothes in another corner. There's a sign to the south next to the steel door.

A heavy, sold steel door. Unlike the door for the janitor's closet, there's no way you'll be able to kick this one down.

You can also see a button here.

>press button
With a mighty tap, you depress the red button, such that it activates a mechanism, triggering a response in an electrical system, which in return activates the motors connected to the steel door, raising said door, revealing a passage to a catwalk to your south.

* * *

>x shelf
A large handy shelf full of things. There are plenty of cleaning supplies here. 

In the Shelf is a Cleaning Supplies.

>Take key
Taken.

>x shelf
A large handy shelf full of things. There are plenty of cleaning supplies here.

>r
That's not a verb I recognise.

>restart
Are you sure you want to restart?

Please answer yes or no.

* * *

>x shelf
A large handy shelf full of things. There are plenty of cleaning supplies here. 

In the Shelf is a Cleaning Supplies.

>Take cleaning supplies
You stick one bottle of the stuff into one of the bigger pockets in your cargo shorts.

>i
You are carrying:
  a Cleaning Supplies

>x door
You see nothing special about the Door to the Janitor's Closet Door.